10 15
| ||  ||  || ||
|   |   |     |
||   |   || |||
|||| |  |    ||
||||      |||||
|||   | | |   |
||   |      |||
||||   || | | |
||||   ||||   |
||||       ||||
